1111111111111111111111111111111111
10E000000000000C00000C000000000001
1010010100100000101001000000010101
1000010010101010001001000000011111
1P1000000C00C0000000000000000C0C11
1111111111111111111111111111111111