1111111111111111111111111111111111
1P000100000011100C0000C00000000001
1I00010100001010111001000000010101
100001111000111001110C000000000001
1I000101C00000C0000I0C001000011011
1000IEI0000C00C00I0000000I00000011
1111110010101010001001000000I10101
1111111111111111111111111111111111
