1111111111111111111111111111111111
1P0000000000000C0000C0000000000011
1I100101001000001I1001000000010101
1I00000000000000CCCCCC000000000001
1I00011111111000CCCCCC001000011001
1000IE0000C00C00I0000000I0000000C1
1111110010101010001001000000I10101
1111111111111111111111111111111111
