1111111111111111111111111111111111
1P000000000011100C0000C00000000001
1000010100001010111001000000010101
100001111000111001110C000000000001
10000001C00000C000000C001000011011
10000E00000C00C0000000000000000011
1111110010101010001001000000010101
1111111111111111111111111111111111
